to play well with - совмещаться с чем то(о  технологии)
executed as plain text - выполняться как простой текст
to evolve - развиваться эволюционировать\
embedded - вложеный
above - вышеупомянутые, вышеупомянутые
For instance - например
feature - черта или признак, функциональнрсть, возможности
apply - применяют
capabilities - способности возможности
allow - позволяьть
perform - исполнять
arbitrary files - произвольные файлы
interact - взаимодействовать
interaction - взаимодействие
remote servers - удаленным серверам
for the sake of - ради чего то, для чего то
aim - цель
prevent - предотвратить
to harm - повреждать
harming - повреждение
restrictions - ограничения
provide - обеспечивать
certain - определенные
explicit permission - явновыраженное разришение
sneakily  - тайком, жульнически
crippled - поврежденный, который не может работать эфективно, ослабленный
remote - удаленный, дистанционный
plugin/extensions - плагины/расширения
recently - недавнно, за последнее время
plethora - огромное количество, изабилие
transpiled - конвертироваться
under the hood - под капотом
precise - точный
initially - первично
amount - количество
attach - прилагать
inserted - вставлять
crucial - очень важный
mentions - с упоминанием
More generally - в более общем смысле
Never the less - тем не мение
swift - юркий, быстрый
reliable - надежный
to take in - принемать
 merely - чисто, явный
 confused - перепутывать, запутываться
 arranged - подготовить, устроить, организовать
 transmitted - передавать, транслировать
opposed - противопоставленный





